role_id,course_id
R001,C001
R001,C002
R001,C003
R001,C004
R002,C001
R003,C001
R003,C028
R004,C001
R004,C029
R004,C035
R005,C001
R005,C012
R005,C013
R005,C014
R006,C001
R006,C067
R006,C080
R007,C001
R007,C055
R008,C001
R009,C001
R009,C058
R009,C067
