role_id,course_id
R001,C001
R001,C002
R001,C003
R001,C004
R001,C005
R001,C006
R001,C007
R001,C008
R001,C009
R001,C010
R002,C001
R002,C002
R002,C003
R002,C011
R003,C012
R003,C013
R003,C014
R004,C008
R004,C016
R005,C012
R005,C013
R005,C014
