role_id,course_id
R001,C001
R001,C002
R001,C003
R001,C004
R001,C005
R001,C006
R001,C007
R001,C008
R001,C009
R001,C010
R001,C011
R001,C012
R001,C013
R002,C001
R003,C001
R003,C012
R003,C013
R003,C014
R004,C001
R004,C008
R004,C016
R005,C001
R005,C012
R005,C013
R005,C014
