role_id,course_id
R001,C001
R001,C047
R001,C048
R002,C001
R003,C001
R003,C002
R003,C003
R003,C004
R003,C005
R003,C006
R003,C007
R003,C008
R003,C009
R003,C010
R003,C011
R003,C012
R003,C013
R003,C014
R003,C015
R003,C016
R004,C001
R004,C029
R004,C035
R005,C001
R005,C012
R005,C013
R005,C014
R006,C001
R006,C067
R006,C080
R007,C001
R007,C055
R008,C001
R009,C001
R009,C058
R009,C067
R010,C001
R011,C001
R012,C001
R013,C001
R014,C001
R015,C001
R016,C001
